t:0:imageZero
t:1:imageOne
p:1
m:0:0:0:0:0:0:0:0:0:0:0:0:0:0:0:0:0:0:0:0:
m:0:0:0:0:0:0:0:0:0:0:0:0:0:0:0:0:0:0:0:0:
m:0:0:0:0:0:0:0:0:0:0:0:0:0:0:0:0:0:0:0:0:
m:0:0:0:0:0:0:0:0:0:0:0:0:0:0:0:0:0:0:0:0:
m:1:1:0:0:0:0:0:0:0:0:0:0:1:1:1:0:0:1:1:1:
m:0:1:1:0:1:1:1:1:0:0:1:1:1:0:1:0:1:1:0:0:
m:0:0:1:1:1:0:0:1:1:1:1:0:0:0:1:0:1:0:0:0:
m:0:0:0:0:0:0:0:0:0:0:0:0:0:0:1:0:1:0:0:0:
m:0:0:0:0:0:0:0:0:0:0:0:0:0:0:1:1:1:0:0:0:
m:0:0:0:0:0:0:0:0:0:0:0:0:0:0:0:0:0:0:0:0:
